11111111
11C100E1
11000011
1P000011
11111111