1111111
1C001E1
1100011
1P00001
1111111