1111111
1C000E1
1100001
1P10001
1111111