1111111
1C100E1
1100001
1P00001
1111111