1111111
1C000E1

1000001
1P00001
1111111